W1 W1 W1 W1 W1 W1 W1 W1 W1 W1 W1 W1 W1 W1 W1 W1 G1 W1 G1 W1 G0 W1 G0 G1
W0 G1 W1 G0 W1 G0 G1 W0 G0 G1 W1 G0 W1 G0 W1 G0 W0 G1 G0 W1 G0 W1 G0 G1
G0 W0 G1 W1 G0 W1 G0 W1 G0 W0 G1 G0 W1 G0 W1 G0 W1 G0 W1 G0 G1 W1 G0 G1
W0 W1 G0 W1 G0 W1 G0 W0 G1 G0 W1 G0 W1 G0 W1 G0 W1 G0 W0 G1 W1 G0 W1 G0
G1 W0 G0 G1 W0 G1 W0 G1 W0 W1 G0 W1 G0 W1 G0 W0 G1 G0 W1 G0 W1 G0 W1 G0
W0 G1 G0 W1 G0 W1 G0 W1 G0 W0 G1 W1 G0 W1 G0 W1 G0 W0 G1 G0 W1 G0 W1 G0
G1 W0 G1 W0 G1 W0 G1 W0 G1 W0 G1 W0 G1 W0 G1 W0 G1 W0 G1 W0 G1 W0 G1 W0
W1 G0 W1 G0 W1 G0 W1 G0 W1 G0 W1 G0 W1 G0 W1 G0 W1 G0 W1 G0 S1 G0 W1 G0
E0 W1 G0 W1 G0 W1 G0 W1 G0 W1 G0 W1 G0 W1 G0 W1 G0 W1 G0 W1 G0 W1 G0 W1
W0 G1 W0 G1 W0 G1 W0 G1 W0 G1 W0 G1 W0 G1 W0 G1 W0 G1 W0 G1 W0 G1 W0 G1
G0 W0 G1 W1 G0 W1 G0 W1 G0 W0 G1 G0 W1 G0 W1 G0 W1 G0 W1 G0 G1 W1 G0 G1
W0 W1 G0 W1 G0 W1 G0 W0 G1 G0 W1 G0 W1 G0 W1 G0 W1 G0 W0 G1 W1 G0 W1 G0
G1 W0 G0 G1 W0 G1 W0 G1 W0 W1 G0 W1 G0 W1 G0 W0 G1 G0 W1 G0 W1 G0 W1 G0
W0 G1 G0 W1 G0 W1 G0 W1 G0 W0 G1 W1 G0 W1 G0 W1 G0 W0 G1 G0 W1 G0 W1 G0
G1 W0 G1 W0 G1 W0 G1 W0 G1 W0 G1 W0 G1 W0 G1 W0 G1 W0 G1 W0 G1 W0 G1 W0
W1 G0 W1 G0 W1 G0 S1 G0 W1 G0 W1 G0 W1 G0 W1 G0 W1 G0 W1 G0 W1 G0 W1 G0
G0 W1 G0 W1 G0 W1 G0 W1 G0 W1 G0 W1 G0 W1 G0 W1 G0 W1 G0 W1 G0 W1 G0 W1
W0 G1 W0 G1 W0 G1 W0 G1 W0 G1 W0 G1 W0 G1 W0 G1 W0 G1 W0 S1 W0 G1 W0 G1
G0 W0 G1 W1 G0 W1 G0 W1 G0 W0 G1 G0 W1 G0 W1 G0 W1 G0 W1 G0 G1 W1 G0 G1
W0 W1 G0 W1 G0 W1 G0 W0 G1 G0 W1 G0 W1 G0 W1 G0 W1 G0 W0 G1 W1 G0 W1 G0
G1 W0 G0 G1 W0 G1 W0 G1 S0 W1 G0 W1 G0 W1 G0 W0 G1 G0 W1 G0 W1 G0 W1 G0
W0 G1 G0 W1 G0 W1 G0 W1 G0 W0 G1 W1 G0 W1 G0 W1 G0 W0 G1 G0 W1 G0 W1 G0
G1 W0 G1 W0 G1 W0 G1 W0 G1 W0 G1 W0 G1 W0 G1 W0 S1 W0 G1 W0 G1 W0 G1 W0
W1 G0 W1 G0 W1 G0 W1 G0 W1 G0 W1 G0 W1 G0 W1 G0 W1 G0 W1 G0 W1 G0 W1 G0
G0 W1 G0 W1 G0 W1 G0 W1 G0 W1 G0 W1 G0 W1 G0 W1 G0 W1 G0 W1 G0 W1 G0 W1
W0 G1 W0 G1 W0 G1 W0 G1 W0 G1 W0 G1 W0 G1 W0 G1 W0 G1 W0 G1 W0 G1 W0 G1
G0 W0 G1 W1 G0 S1 G0 W1 G0 W0 G1 G0 W1 G0 W1 G0 W1 G0 W1 G0 G1 W1 G0 G1
W0 W1 G0 W1 G0 W1 G0 W0 G1 G0 W1 G0 W1 G0 W1 G0 W1 G0 W0 G1 W1 G0 W1 G0
G1 W0 G0 G1 W0 G1 W0 G1 W0 W1 G0 W1 G0 W1 G0 W0 G1 G0 W1 G0 W1 G0 W1 G0
W0 G1 G0 W1 G0 W1 G0 W1 G0 W0 G1 W1 G0 W1 G0 W1 G0 W0 G1 G0 W1 G0 W1 G0